###############
######...######
###.........###
#.............#
#.............#
#.............#
#.............#
#......@......#
#.............#
#.............#
#.............#
###.........###
######...######
###############