###############
###......######
###.###########
#.............#
#############.#
#.............#
#.#############
#.............#
#############.#
#.............#
#.#############
#.............#
######...####@#
###############